1 1 1 1 4 4 4
1 3 0 1 1 4 4
1 3 5 0 1 4 4
1 3 0 2 1 4 4
1 1 2 0 1 1 1
4 1 0 2 0 0 1
4 1 0 0 0 0 1
4 1 0 0 1 1 1
4 1 1 1 1 4 4
